10 1 1 3
20 4 1 2
30 2 1 4
40 1 1 1
40 2 1 1
40 3 1 1
50 4 1 3
60 1 1 2
60 3 1 2
