3 4 1 1
5 2 1 1
7 3 1 2
10 1 1 2
14 2 1 2
18 3 1 1
23 1 2 2
27 4 3 3
33 1 2 2
36 4 3 1
39 1 2 2
45 4 3 3
50 2 2 3
55 3 3 2
60 2 2 2
65 4 4 1
68 1 4 1
72 2 4 2
80 2 100 1
